NO ./textures/eagle.xpm



F 220,100,0

WE                 ./textures/a.xpm

EA    ./textures/red_brick.xpm

C 225,30,0
SO ./textures/wall_1.xpm

11111
10001
10W01
10001
11111