NO ./textures/wall_1.xpm
SO ./textures/blue_stone.xpm
WE ./textures/eagle.xpm
EA ./textures/red_brick.xpm

F 220,0,0
C 0,220,0

11111111111111111111111111
10000000000000000000000001
10000000000000001110000001
1000000000000000W000000001
10000000000000000000000001
10011000000000000000000001
10000000000000000001110001
11111111111111111111111111