NO ./textures/eagle.xpm
EA    ./textures/red_brick.xpm
SO ./textures/wall_1.xpm
WE                 ./textures/blue_stone.xpm


F 100,100,0
C 0,0,100


11111
10001
10W01
10101
11111